1111111111111
1P0100C000M01
1001001111001
100M001E0M001
1111111111111