1111111111111
1P0100C000M01
10010011110M1
100M001E0M0C1
1111111111111