1111111111111
1P0100C000001
1001001111001
1000001E000C1
1111111111111